00100110
00100000
10100000
10000000
10000000
00000000
01111000